*****************
*1       4      *
*               *
*           6   *
*     3         *
*               *
*  S            *
*      7        *
* 2             *
*         5     *
*  B            *
*****************
.